#######################################
#                                     #
#                          #          #
#     #############        #          #
#     #                    #          #
#     #     #              #          #
#     #     ################          #
#           #                         #
#     #######                         #
#     #             ###################
#     #                      #        #
#     #                      #        #
#                                     #
#######################################